111111111111111111111111111111
10001000010000000000C1111100C1
101000110100C111000010C1000001
1C0011000000000010000000000001
1000E100001000100000100001C001
111111000100001010010000100011
1111000100010000100000C1001001
11C0000100C0001010101001001001
1110010000000P1C1C0C10000000C1
100000000000111000000000010001
10101000000000C100000000100001
101001000110000000000C01001101
100C10011000001000100101001001
100111010C000100001001001C0001
110000000000000010000C000000C1
111111111111111111111111111111
